Module,TXT,RO,DATA,BSS,TOTAL,FatalCount,F3Count
modem_proc/sierra/rf/sierra_rf.lib/rfant.o,1372,305,21,12,1710,2,16
modem_proc/sierra/rf/sierra_rf.lib/rftask.o,432,237,0,352,1021,3,5
modem_proc/sierra/rf/sierra_rf.lib/rfpwr.o,1008,352,0,0,1360,0,3
modem_proc/sierra/rf/sierra_rf.lib/rfsar.o,1168,214,0,16,1398,3,3
modem_proc/sierra/rf/sierra_rf.lib/rfsar_cdma.o,832,219,0,0,1051,1,4
modem_proc/sierra/rf/sierra_rf.lib/rfsar_gsm.o,792,64,0,0,856,0,8
modem_proc/sierra/rf/sierra_rf.lib/rfsar_lte.o,2220,1208,0,0,3428,2,8
modem_proc/sierra/rf/sierra_rf.lib/rfsar_wcdma.o,1008,440,0,0,1448,0,10
modem_proc/sierra/rf/sierra_rf.lib/rftherm.o,196,108,0,0,304,0,6
modem_proc/sierra/rf/sierra_rf.lib/rfuser.o,1656,105,0,56,1817,0,10
modem_proc/sierra/sc/sierra_sc.lib/sctask.o,916,504,3,752,2175,7,11
modem_proc/sierra/sc/sierra_sc.lib/scnet.o,6168,1434,0,528,8130,9,100
modem_proc/sierra/sc/sierra_sc.lib/scuser.o,916,180,0,0,1096,0,14
modem_proc/sierra/sc/sierra_sc.lib/scsession.o,1416,352,0,96,1864,2,26
modem_proc/sierra/sc/sierra_sc.lib/scprofile.o,2176,633,0,24,2833,1,52
modem_proc/sierra/sl/sierra_sl.lib/sluser.o,5212,264,24,0,5500,0,5
modem_proc/sierra/sl/sierra_sl.lib/slvsprintf.o,48,0,0,0,48,0,0
modem_proc/sierra/sm/sierra_sm.lib/sm.o,200,195,0,0,395,3,3
modem_proc/sierra/sntp/sierra_sntp.lib/sntp_task.o,1520,463,0,360,2343,3,27
modem_proc/sierra/so/sierra_so.lib/sotask.o,10644,5481,8,15624,31757,50,187
modem_proc/sierra/so/sierra_so.lib/souser.o,7280,2809,0,0,10089,36,122
modem_proc/sierra/sp/sierra_sp.lib/spdecrypt.o,240,0,0,0,240,0,0
modem_proc/sierra/sp/sierra_sp.lib/spencrypt.o,264,62,0,0,326,1,0
modem_proc/sierra/sp/sierra_sp.lib/spcommon.o,372,0,5,256,633,0,0
modem_proc/sierra/ssmem/sierra_ssmem.lib/ssmem_user.o,796,40,0,0,836,0,5
modem_proc/sierra/ssmem/sierra_ssmem.lib/ssmem_utils.o,520,48,0,0,568,0,6
modem_proc/sierra/ssmem/sierra_ssmem.lib/ssmem_bscommon.o,80,8,0,8,96,0,1
modem_proc/sierra/ssmem/sierra_ssmem.lib/ssmem_modem.o,44,0,0,16,60,0,0
modem_proc/sierra/ssmem/sierra_ssmem.lib/ssmem_core.o,908,56,0,24,988,0,7
modem_proc/sierra/su/sierra_su.lib/suuser.o,352,59,0,56,467,1,1
modem_proc/sierra/swipart/sierra_swipart.lib/swipart_backup.o,1256,677,0,8,1941,9,20
modem_proc/sierra/swipart/sierra_swipart.lib/swipart_modem.o,2460,1144,0,0,3604,6,44
modem_proc/sierra/swipart/sierra_swipart.lib/swipart_slot.o,716,187,0,2,905,2,7
modem_proc/sierra/swipart/sierra_swipart.lib/swipart_user.o,3244,1424,12,4103,8783,20,35
modem_proc/sierra/swipart/sierra_swipart.lib/swipart_fota.o,1436,1126,0,23,2585,3,46
modem_proc/sierra/swiqmi/sierra_swiqmi.lib/swiqmi_nas.o,5504,2525,16,80,8125,16,111
modem_proc/sierra/swiqmi/sierra_swiqmi.lib/swiqmi_dms.o,8644,2604,0,0,11248,22,129
modem_proc/sierra/swiqmi/sierra_swiqmi.lib/swiqmi_dms_im.o,1848,558,0,0,2406,3,25
modem_proc/sierra/swiqmi/sierra_swiqmi.lib/swiqmi_wake.o,2448,926,156,48168,51698,14,30
modem_proc/sierra/swiqmi/sierra_swiqmi.lib/swiqmi_wds.o,5088,1285,0,1064,7437,14,44
modem_proc/sierra/swiqmi/sierra_swiqmi.lib/swiqmi_if.o,684,344,12,4,1044,6,2
modem_proc/sierra/swiqmi/sierra_swiqmi.lib/swiqmi_omadm.o,3888,1557,56,196,5697,19,44
modem_proc/sierra/swiqmi/sierra_swiqmi.lib/swiqmi_sar.o,1704,708,32,64,2508,6,27
modem_proc/sierra/swiqmi/sierra_swiqmi.lib/swiqmi_loc.o,1784,673,16,280,2753,8,20
modem_proc/sierra/swiqmi/sierra_swiqmi.lib/swiqmi_swidms.o,2156,761,72,280,3269,9,34
modem_proc/sierra/ud/sierra_ud_modem.lib/uduser.o,1224,171,16,8,1419,1,14
modem_proc/sierra/ud/sierra_ud_modem.lib/uduser_modem.o,984,207,0,0,1191,1,1
modem_proc/sierra/ud/sierra_ud_modem.lib/ud_qapi_modem.o,12,0,1,0,13,0,0
modem_proc/sierra/ud/sierra_ud_modem.lib/ud_descriptor.o,0,380,0,0,380,0,0
modem_proc/sierra/uicc/sierra_uicc.lib/uiccuser.o,8964,8563,56,448,18031,14,257
modem_proc/sierra/uicc/sierra_uicc.lib/uicctask.o,1488,743,0,372,2603,4,20
modem_proc/sierra/usl/sierra_usl_modem.lib/usl.o,2076,7476,144,20,9716,0,17
modem_proc/sierra/usl/sierra_usl_modem.lib/usldsat.o,1000,132,0,16,1148,0,15
modem_proc/sierra/usl/sierra_usl_modem.lib/usluser.o,5064,1164,50,9752,16030,0,85
modem_proc/sierra/aa/sierra_aa.lib/aaversion_util.o,452,0,0,0,452,0,0
modem_proc/sierra/aa/sierra_aa.lib/aaversion.o,96,326,0,0,422,5,0
modem_proc/sierra/al/sierra_al.lib/altask.o,6736,2711,8,328,9783,5,77
modem_proc/sierra/al/sierra_al.lib/aluser.o,4708,959,0,8,5675,1,56
modem_proc/sierra/al/sierra_al.lib/dtls.o,14436,6040,9,0,20485,0,0
modem_proc/sierra/al/sierra_al.lib/crypto.o,2136,131,0,180,2447,0,0
modem_proc/sierra/al/sierra_al.lib/ccm.o,1716,0,0,4,1720,0,0
modem_proc/sierra/al/sierra_al.lib/hmac.o,384,0,0,0,384,0,0
modem_proc/sierra/al/sierra_al.lib/dtls_debug.o,4,0,0,0,4,0,0
modem_proc/sierra/al/sierra_al.lib/netq.o,356,23,0,0,379,0,0
modem_proc/sierra/al/sierra_al.lib/peer.o,152,14,0,0,166,0,0
modem_proc/sierra/al/sierra_al.lib/dtls_time.o,40,0,4,0,44,0,0
modem_proc/sierra/al/sierra_al.lib/session.o,184,0,0,0,184,0,0
modem_proc/sierra/al/sierra_al.lib/rijndael.o,1952,5160,8,0,7120,0,0
modem_proc/sierra/al/sierra_al.lib/sha2.o,1456,288,0,0,1744,0,0
modem_proc/sierra/al/sierra_al.lib/ecc.o,3268,236,0,0,3504,0,0
modem_proc/sierra/al/sierra_al.lib/liblwm2m.o,1884,612,0,0,2496,0,0
modem_proc/sierra/al/sierra_al.lib/utils.o,2352,64,56,0,2472,0,0
modem_proc/sierra/al/sierra_al.lib/objects.o,10936,4322,2,52,15312,0,0
modem_proc/sierra/al/sierra_al.lib/data.o,2828,921,0,0,3749,0,0
modem_proc/sierra/al/sierra_al.lib/list.o,276,0,0,0,276,0,0
modem_proc/sierra/al/sierra_al.lib/packet.o,3536,2330,0,324,6190,0,0
modem_proc/sierra/al/sierra_al.lib/transaction.o,1756,272,0,0,2028,0,0
modem_proc/sierra/al/sierra_al.lib/registration.o,3176,617,0,0,3793,0,0
modem_proc/sierra/al/sierra_al.lib/bootstrap.o,3748,764,0,0,4512,0,0
modem_proc/sierra/al/sierra_al.lib/management.o,2300,172,0,0,2472,0,0
modem_proc/sierra/al/sierra_al.lib/observe.o,4672,1104,0,4,5780,0,0
modem_proc/sierra/al/sierra_al.lib/discover.o,2384,28,0,0,2412,0,0
modem_proc/sierra/al/sierra_al.lib/block1.o,292,0,0,0,292,0,0
modem_proc/sierra/al/sierra_al.lib/acl.o,1808,960,3,0,2771,0,0
modem_proc/sierra/al/sierra_al.lib/er-coap-13.o,4260,232,4,0,4496,0,0
modem_proc/sierra/al/sierra_al.lib/handlers.o,5036,1812,0,2048,8896,0,0
modem_proc/sierra/al/sierra_al.lib/lwm2mcoreCoapHandlers.o,260,112,0,8,380,0,0
modem_proc/sierra/al/sierra_al.lib/bootstrapConfiguration.o,2700,1127,0,16,3843,0,0
modem_proc/sierra/al/sierra_al.lib/aclConfiguration.o,2040,1009,0,12,3061,0,0
modem_proc/sierra/al/sierra_al.lib/dtlsConnection.o,3452,1770,28,0,5250,0,0
modem_proc/sierra/al/sierra_al.lib/lwm2mcoreSession.o,6040,3240,4,32,9316,0,0
modem_proc/sierra/al/sierra_al.lib/paramStorage.o,1052,400,0,56,1508,0,24
modem_proc/sierra/al/sierra_al.lib/timer.o,260,40,0,1360,1660,0,3
modem_proc/sierra/al/sierra_al.lib/time.o,4,0,0,0,4,0,0
modem_proc/sierra/al/sierra_al.lib/device.o,2176,296,0,0,2472,0,13
modem_proc/sierra/al/sierra_al.lib/connectivity.o,3296,663,0,256,4215,6,24
modem_proc/sierra/al/sierra_al.lib/platform.o,180,221,0,0,401,5,0
modem_proc/sierra/al/sierra_al.lib/debug.o,164,98,0,6412,6674,1,2
modem_proc/sierra/al/sierra_al.lib/security.o,2264,836,0,12,3112,0,40
modem_proc/sierra/al/sierra_al.lib/udp.o,3896,943,0,1312,6151,2,62
modem_proc/sierra/al/sierra_al.lib/comm.o,240,227,0,0,467,0,0
modem_proc/sierra/al/sierra_al.lib/server.o,108,67,8,0,183,1,0
modem_proc/sierra/al/sierra_al.lib/sms.o,2708,720,4,2488,5920,2,64
modem_proc/sierra/al/sierra_al.lib/sim.o,32,8,0,0,40,0,1
modem_proc/sierra/al/sierra_al.lib/update.o,2420,931,0,1368,4719,0,0
modem_proc/sierra/al/sierra_al.lib/tableSelector.o,32,0,0,0,32,0,0
modem_proc/sierra/al/sierra_al.lib/objectsTable_generic.o,8,0,1264,0,1272,0,0
modem_proc/sierra/al/sierra_al.lib/objectsTable_vzw.o,676,129,1464,0,2269,0,2
modem_proc/sierra/al/sierra_al.lib/uri.o,1396,250,0,0,1646,0,0
modem_proc/sierra/al/sierra_al.lib/tlv.o,2136,288,0,0,2424,0,0
modem_proc/sierra/al/sierra_al.lib/workspace.o,284,1740,0,0,2024,0,0
modem_proc/sierra/at/sierra_at.lib/atsim_ex.o,15772,7275,1168,19295,43510,4,312
modem_proc/sierra/at/sierra_at.lib/atsp.o,2236,134,16,61,2447,1,4
modem_proc/sierra/at/sierra_at.lib/atutil.o,1804,107,0,0,1911,1,3
modem_proc/sierra/at/sierra_at.lib/atmep.o,3468,1105,0,432,5005,13,33
modem_proc/sierra/at/sierra_at.lib/atsim.o,5408,2848,0,0,8256,0,104
modem_proc/sierra/at/sierra_at.lib/atat.o,792,96,0,0,888,0,4
modem_proc/sierra/at/sierra_at.lib/atavms.o,2364,581,0,16,2961,0,41
modem_proc/sierra/at/sierra_at.lib/atda.o,4488,905,0,8,5401,15,3
modem_proc/sierra/at/sierra_at.lib/atgd.o,16808,12883,8,5008,34707,32,90
modem_proc/sierra/at/sierra_at.lib/atgps.o,15376,6934,8,80,22398,13,42
modem_proc/sierra/at/sierra_at.lib/atims.o,5888,1063,0,824,7775,3,72
modem_proc/sierra/at/sierra_at.lib/atmain.o,20,0,0,0,20,0,0
modem_proc/sierra/at/sierra_at.lib/atnv.o,8576,3160,0,2048,13784,13,42
modem_proc/sierra/at/sierra_at.lib/atqc.o,1436,611,0,0,2047,4,0
modem_proc/sierra/at/sierra_at.lib/atrf.o,9064,3751,24,10,12849,2,28
modem_proc/sierra/at/sierra_at.lib/atpc.o,3904,1176,280,142,5502,8,8
modem_proc/sierra/at/sierra_at.lib/atsc.o,1904,688,3,1,2596,3,15
modem_proc/sierra/at/sierra_at.lib/atso.o,104,80,8,23,215,0,10
modem_proc/sierra/at/sierra_at.lib/atsd.o,14864,10955,2,2504,28325,2,112
modem_proc/sierra/at/sierra_at.lib/atav.o,11628,4060,0,0,15688,0,337
modem_proc/sierra/at/sierra_at.lib/atvzw.o,2084,580,0,0,2664,0,34
modem_proc/sierra/at/sierra_at.lib/atplus.o,4868,2515,0,8,7391,13,64
modem_proc/sierra/at/sierra_at.lib/atdbi.o,176,254,0,0,430,0,2
modem_proc/sierra/at/sierra_at.lib/attcxo.o,364,128,0,0,492,0,1
modem_proc/sierra/at/sierra_at.lib/attm.o,580,890,0,0,1470,0,7
modem_proc/sierra/at/sierra_at.lib/atusl.o,1492,348,0,0,1840,0,18
modem_proc/sierra/at/sierra_at.lib/atuart.o,368,69,0,0,437,0,5
modem_proc/sierra/at/sierra_at.lib/atri.o,1932,329,12,8,2281,0,26
modem_proc/sierra/at/sierra_at.lib/atxm.o,4356,957,48,528,5889,6,65
modem_proc/sierra/at/sierra_at.lib/atmuxmode.o,56,8,0,0,64,0,1
modem_proc/sierra/at/sierra_at.lib/atap.o,5888,914,0,0,6802,0,36
modem_proc/sierra/at/sierra_at.lib/atbc.o,1700,182,0,88,1970,0,0
modem_proc/sierra/at/sierra_at.lib/atbs.o,5816,4172,736,0,10724,0,35
modem_proc/sierra/at/sierra_at.lib/atcust.o,2172,555,0,0,2727,0,15
modem_proc/sierra/at/sierra_at.lib/atdata.o,1004,445,0,0,1449,0,3
modem_proc/sierra/at/sierra_at.lib/atef.o,2100,344,0,262144,264588,0,16
modem_proc/sierra/at/sierra_at.lib/ater.o,1396,1049,0,0,2445,3,5
modem_proc/sierra/at/sierra_at.lib/atdm.o,2012,2385,0,0,4397,0,35
modem_proc/sierra/at/sierra_at.lib/atflog.o,432,16,120,0,568,0,2
modem_proc/sierra/at/sierra_at.lib/atfm.o,3360,963,1032,1024,6379,0,21
modem_proc/sierra/at/sierra_at.lib/atids.o,4868,2596,0,0,7464,4,9
modem_proc/sierra/at/sierra_at.lib/atimsw.o,2432,1280,0,0,3712,0,12
modem_proc/sierra/at/sierra_at.lib/atjam.o,276,96,0,0,372,0,3
modem_proc/sierra/at/sierra_at.lib/atld.o,192,144,0,0,336,0,3
modem_proc/sierra/at/sierra_at.lib/atmm.o,168,120,0,0,288,0,2
modem_proc/sierra/at/sierra_at.lib/atos.o,780,538,72,0,1390,3,3
modem_proc/sierra/at/sierra_at.lib/atsec.o,2192,467,24,0,2683,0,29
modem_proc/sierra/at/sierra_at.lib/atsmswake.o,984,334,0,0,1318,0,0
modem_proc/sierra/at/sierra_at.lib/atssmem.o,1040,667,0,0,1707,0,1
modem_proc/sierra/at/sierra_at.lib/atud.o,2648,2087,0,0,4735,0,6
modem_proc/sierra/at/sierra_at.lib/atvendor.o,0,5016,0,0,5016,0,0
modem_proc/sierra/at/sierra_at.lib/atvendor_ex.o,0,16616,28,0,16644,0,0
modem_proc/sierra/at/sierra_at.lib/atvendorsprint.o,0,192,0,0,192,0,0
modem_proc/sierra/at/sierra_at.lib/atvendorsprint_ex.o,0,560,0,0,560,0,0
modem_proc/sierra/av/sierra_av.lib/av_swiqmi_mpss.o,8272,2680,0,20,10972,0,282
modem_proc/sierra/bs/sierra_bs.lib/bsio.o,2608,525,12,984,4129,1,35
modem_proc/sierra/bs/sierra_bs.lib/bsuser.o,4044,1241,16,44,5345,8,26
modem_proc/sierra/bs/sierra_bs.lib/bs_qapi.o,640,180,0,8,828,1,16
modem_proc/sierra/bs/sierra_bs.lib/bswake.o,216,8,0,12,236,0,1
modem_proc/sierra/bs/sierra_bs.lib/bsunusedgpio.o,48,848,0,0,896,0,1
modem_proc/sierra/bs/sierra_bs.lib/bsadc.o,412,41,256,5,714,0,2
modem_proc/sierra/bs/sierra_bs.lib/bssleep.o,684,175,2,2,863,0,7
modem_proc/sierra/bs/sierra_bs.lib/bs_ksleep_qapi_cli.o,396,151,0,5,552,1,8
modem_proc/sierra/bs/sierra_bs.lib/bsdisable.o,504,152,1,12,669,2,3
modem_proc/sierra/bs/sierra_bs.lib/bsfuse.o,428,80,0,0,508,0,10
modem_proc/sierra/bs/sierra_bs.lib/bsmem.o,128,266,256,4,654,5,1
modem_proc/sierra/bs/sierra_bs.lib/bsled.o,448,40,32,8,528,0,5
modem_proc/sierra/bs/sierra_bs.lib/bsp_swiqmi_mpss.o,1552,1238,0,16,2806,0,61
modem_proc/sierra/bs/sierra_bs.lib/bs_uart.o,224,76,0,0,300,1,2
modem_proc/sierra/bs/sierra_bs.lib/bsextgpio.o,5388,647,1664,2740,10439,0,72
modem_proc/sierra/bs/sierra_bs.lib/bssargpio.o,768,119,0,0,887,0,11
modem_proc/sierra/cf/sierra_cf.lib/cftask.o,584,253,0,256,1093,3,7
modem_proc/sierra/cf/sierra_cf.lib/cfuser.o,228,75,0,0,303,1,2
modem_proc/sierra/cf/sierra_cf.lib/cfflash.o,1112,314,0,0,1426,4,13
modem_proc/sierra/cf/sierra_cf.lib/cfdownload.o,2324,951,0,0,3275,8,38
modem_proc/sierra/cf/sierra_cf.lib/cfsocket.o,1064,237,0,102664,103965,1,19
modem_proc/sierra/cf/sierra_cf.lib/http.o,924,80,0,0,1004,0,0
modem_proc/sierra/cf/sierra_cf.lib/header.o,168,128,0,0,296,0,0
modem_proc/sierra/cf/sierra_cf.lib/chunk.o,244,20,0,0,264,0,0
modem_proc/sierra/data/sierra_data.lib/data_qapi.o,764,128,0,8,900,0,16
modem_proc/sierra/data/sierra_data.lib/ds_proxy.o,2008,240,0,292,2540,0,30
modem_proc/sierra/flog/sierra_flog.lib/flogtask.o,7972,1827,14,1112,10925,6,111
modem_proc/sierra/flog/sierra_flog.lib/flog_mpss.o,4,0,0,0,4,0,0
modem_proc/sierra/flog/sierra_flog.lib/floguser.o,824,251,0,0,1075,4,3
modem_proc/sierra/fm/sierra_fm.lib/fm_modem.o,1004,237,16,3928,5185,1,6
modem_proc/sierra/fm/sierra_fm.lib/fmutils.o,3344,1252,0,32,4628,8,50
modem_proc/sierra/fm/sierra_fm.lib/fm_sfs.o,1556,838,0,0,2394,0,33
modem_proc/sierra/fm/sierra_fm.lib/fmtask.o,896,741,0,256,1893,16,0
modem_proc/sierra/fm/sierra_fm.lib/fm_remote_svc.o,1408,1134,0,80,2622,13,13
modem_proc/sierra/fm/sierra_fm.lib/fm_remote_cli.o,1760,1152,0,5,2917,12,32
modem_proc/sierra/gps/sierra_gps.lib/gpstask.o,11976,3078,36,24665,39755,24,127
modem_proc/sierra/gps/sierra_gps.lib/gpsuser.o,3360,1134,8,6,4508,14,25
modem_proc/sierra/gps/sierra_gps.lib/gpssc.o,1576,398,0,0,1974,1,32
modem_proc/sierra/gps/sierra_gps.lib/gpsxtradata.o,4648,1194,0,0,5842,6,79
modem_proc/sierra/gps/sierra_gps.lib/gpsxtratime.o,2304,420,8,0,2732,1,39
modem_proc/sierra/gps/sierra_gps.lib/gpsdr.o,648,88,4,0,740,0,11
modem_proc/sierra/ids/sierra_ids.lib/idstask.o,7252,864,4,4772,12892,5,27
modem_proc/sierra/ids/sierra_ids.lib/idsuser.o,2860,3072,0,220,6152,11,17
modem_proc/sierra/ids/sierra_ids.lib/idssocket.o,3728,716,102600,64,107108,2,65
modem_proc/sierra/ids/sierra_ids.lib/idstree.o,18096,5932,56,28,24112,13,98
modem_proc/sierra/ids/sierra_ids.lib/idssession.o,8920,1596,64,104,10684,0,65
modem_proc/sierra/ids/sierra_ids.lib/idsutil.o,4772,1990,0,7700,14462,22,43
modem_proc/sierra/ids/sierra_ids.lib/idsfumo.o,6108,1873,0,5,7986,0,114
modem_proc/sierra/ids/sierra_ids.lib/idssignature.o,1432,1227,0,1,2660,0,24
modem_proc/sierra/ids/sierra_ids.lib/idsavms.o,1356,796,0,0,2152,0,52
modem_proc/sierra/ids/sierra_ids.lib/idssms.o,6560,1519,8,2346,10433,5,153
modem_proc/sierra/ids/sierra_ids.lib/idswu.o,7996,1702,0,140,9838,9,101
modem_proc/sierra/ids/sierra_ids.lib/idsstubs.o,52,0,0,0,52,0,0
modem_proc/sierra/ids/sierra_ids.lib/idsui.o,7448,1260,21,8788,17517,2,89
modem_proc/sierra/ids/sierra_ids.lib/idsflash.o,2868,529,4,112,3513,3,37
modem_proc/sierra/ids/sierra_ids.lib/idsfdt.o,3088,580,3,24,3695,0,59
modem_proc/sierra/ids/sierra_ids.lib/idssprint.o,32356,8140,8,9488,49992,8,232
modem_proc/sierra/ids/sierra_ids.lib/idsvzw.o,16272,9033,224,2576,28105,8,77
modem_proc/sierra/ids/sierra_ids.lib/idsprofile.o,2300,641,0,0,2941,8,14
modem_proc/sierra/ids/sierra_ids.lib/idsims.o,2224,272,0,0,2496,0,18
modem_proc/sierra/ids/sierra_ids.lib/idsdx.o,516,8,0,8,532,0,1
modem_proc/sierra/ids/sierra_ids.lib/idsdxwwan.o,2992,1106,32,1400,5530,11,20
modem_proc/sierra/ids/sierra_ids.lib/idsfm.o,372,228,0,0,600,2,4
modem_proc/sierra/ids/sierra_ids.lib/rdms_utils.o,160,68,0,0,228,0,0
modem_proc/sierra/ids/sierra_ids.lib/omc_strlen.o,4,0,0,0,4,0,0
modem_proc/sierra/ids/sierra_ids.lib/omc_iu32toa.o,176,0,0,0,176,0,0
modem_proc/sierra/ids/sierra_ids.lib/omc_memset.o,4,0,0,0,4,0,0
modem_proc/sierra/ids/sierra_ids.lib/omc_memalloc.o,8,0,0,0,8,0,0
modem_proc/sierra/ids/sierra_ids.lib/omc_time.o,4,0,0,0,4,0,0
modem_proc/sierra/ids/sierra_ids.lib/omc_globals.o,8,0,0,28,36,0,0
modem_proc/sierra/ids/sierra_ids.lib/tree_init.o,2592,689,0,0,3281,0,0
modem_proc/sierra/ids/sierra_ids.lib/tree_add.o,912,0,0,0,912,0,0
modem_proc/sierra/ids/sierra_ids.lib/tree_exec.o,408,200,0,0,608,0,0
modem_proc/sierra/ids/sierra_ids.lib/tree_find.o,1016,101,0,0,1117,0,0
modem_proc/sierra/ids/sierra_ids.lib/tree_get.o,3344,243,0,0,3587,0,0
modem_proc/sierra/ids/sierra_ids.lib/omc_control.o,2100,611,0,0,2711,0,0
modem_proc/sierra/ids/sierra_ids.lib/omc_base64.o,1104,272,0,0,1376,0,0
modem_proc/sierra/ids/sierra_ids.lib/tman_external.o,260,314,0,0,574,0,0
modem_proc/sierra/ids/sierra_ids.lib/tman_get.o,1796,226,0,0,2022,0,0
modem_proc/sierra/ids/sierra_ids.lib/tman_init.o,88,26,0,0,114,0,0
modem_proc/sierra/ids/sierra_ids.lib/tman_read.o,968,285,0,0,1253,0,0
modem_proc/sierra/ids/sierra_ids.lib/tman_replace.o,2420,565,0,0,2985,0,0
modem_proc/sierra/ids/sierra_ids.lib/tman_session.o,172,40,0,0,212,0,0
modem_proc/sierra/ids/sierra_ids.lib/tman_util.o,976,108,0,0,1084,0,0
modem_proc/sierra/ids/sierra_ids.lib/trg_info.o,252,184,0,0,436,0,0
modem_proc/sierra/ids/sierra_ids.lib/trg_notification.o,668,381,0,0,1049,0,0
modem_proc/sierra/ids/sierra_ids.lib/trg_dm_user.o,248,0,0,0,248,0,0
modem_proc/sierra/ids/sierra_ids.lib/mgr.o,756,50,0,0,806,0,0
modem_proc/sierra/ids/sierra_ids.lib/wsm.o,3596,0,0,0,3596,0,0
modem_proc/sierra/ids/sierra_ids.lib/wsm_sm.o,880,0,0,0,880,0,0
modem_proc/sierra/ids/sierra_ids.lib/sess_alert.o,476,158,0,0,634,0,0
modem_proc/sierra/ids/sierra_ids.lib/sess_prot.o,1048,323,0,0,1371,0,0
modem_proc/sierra/ids/sierra_ids.lib/sess_queue.o,1044,414,0,0,1458,0,0
modem_proc/sierra/ids/sierra_ids.lib/sess_utils.o,4936,309,0,0,5245,0,0
modem_proc/sierra/ids/sierra_ids.lib/session.o,2484,537,0,0,3021,0,0
modem_proc/sierra/ids/sierra_ids.lib/dm_session.o,748,324,0,0,1072,0,0
modem_proc/sierra/ids/sierra_ids.lib/sess_dm_alert.o,2100,166,0,0,2266,0,0
modem_proc/sierra/ids/sierra_ids.lib/sess_dm_boot.o,3196,1067,0,0,4263,0,0
modem_proc/sierra/ids/sierra_ids.lib/sess_dm_processcmds.o,4020,202,0,0,4222,0,0
modem_proc/sierra/ids/sierra_ids.lib/sess_dm_utils.o,1684,246,0,0,1930,0,0
modem_proc/sierra/ids/sierra_ids.lib/xmlparseutils.o,1368,46,0,0,1414,0,0
modem_proc/sierra/ids/sierra_ids.lib/omadl_parsedd.o,3412,1514,0,0,4926,0,0
modem_proc/sierra/ids/sierra_ids.lib/omadl_comms_if.o,1700,499,0,0,2199,0,0
modem_proc/sierra/ids/sierra_ids.lib/omadl_dev_if.o,740,368,0,0,1108,0,0
modem_proc/sierra/ids/sierra_ids.lib/fumo_download.o,344,105,0,0,449,0,0
modem_proc/sierra/ids/sierra_ids.lib/fumo_session.o,3020,1127,0,0,4147,0,0
modem_proc/sierra/ids/sierra_ids.lib/fumo_storage.o,1380,876,0,0,2256,0,0
modem_proc/sierra/ids/sierra_ids.lib/fumo_update.o,328,240,0,0,568,0,0
modem_proc/sierra/ids/sierra_ids.lib/fumo_trigger_if.o,4,0,0,0,4,0,0
modem_proc/sierra/ids/sierra_ids.lib/fumo_ua_if.o,1224,840,0,0,2064,0,0
modem_proc/sierra/ids/sierra_ids.lib/tnds_common.o,584,416,0,0,1000,0,0
modem_proc/sierra/ids/sierra_ids.lib/tnds_decodewbxml.o,2216,88,0,0,2304,0,0
modem_proc/sierra/ids/sierra_ids.lib/tnds_decodexml.o,3176,142,0,0,3318,0,0
modem_proc/sierra/ids/sierra_ids.lib/tnds_encode.o,3272,155,0,0,3427,0,0
modem_proc/sierra/ids/sierra_ids.lib/da_workspace.o,500,250,0,0,750,0,0
modem_proc/sierra/ids/sierra_ids.lib/da_foto.o,228,84,0,0,312,0,0
modem_proc/sierra/ids/sierra_ids.lib/ua_workspace.o,48,0,0,0,48,0,0
modem_proc/sierra/ids/sierra_ids.lib/ssp_workspace.o,1148,619,4,0,1771,0,0
modem_proc/sierra/ids/sierra_ids.lib/ssp_wsstatics.o,8,0,0,156,164,0,0
modem_proc/sierra/ids/sierra_ids.lib/ssp_adler32.o,400,0,0,0,400,0,0
modem_proc/sierra/ids/sierra_ids.lib/flash_if.o,36,0,0,0,36,0,0
modem_proc/sierra/ids/sierra_ids.lib/aes.o,3796,17762,0,0,21558,0,0
modem_proc/sierra/ids/sierra_ids.lib/sha1.o,2804,320,32,0,3156,0,0
modem_proc/sierra/ids/sierra_ids.lib/ltm_desc.o,1328,232,0,0,1560,0,0
modem_proc/sierra/ids/sierra_ids.lib/crypt_find_hash.o,68,0,0,0,68,0,0
modem_proc/sierra/ids/sierra_ids.lib/crypt_register_cipher.o,112,0,0,0,112,0,0
modem_proc/sierra/ids/sierra_ids.lib/crypt_register_hash.o,112,0,0,0,112,0,0
modem_proc/sierra/ids/sierra_ids.lib/zeromem.o,28,0,0,0,28,0,0
modem_proc/sierra/ids/sierra_ids.lib/ltc_ecc_map.o,348,0,0,0,348,0,0
modem_proc/sierra/ids/sierra_ids.lib/ltc_ecc_mulmod.o,1248,0,0,0,1248,0,0
modem_proc/sierra/ids/sierra_ids.lib/ltc_ecc_points.o,124,0,0,0,124,0,0
modem_proc/sierra/ids/sierra_ids.lib/ltc_ecc_projective_add_point.o,2040,0,0,0,2040,0,0
modem_proc/sierra/ids/sierra_ids.lib/ltc_ecc_projective_dbl_point.o,1336,0,0,0,1336,0,0
modem_proc/sierra/ids/sierra_ids.lib/rsa_exptmod.o,460,0,0,0,460,0,0
modem_proc/sierra/ids/sierra_ids.lib/rsa_import.o,780,0,0,0,780,0,0
modem_proc/sierra/ids/sierra_ids.lib/rsa_make_key.o,820,0,0,0,820,0,0
modem_proc/sierra/ids/sierra_ids.lib/rsa_verify_hash.o,564,0,0,0,564,0,0
modem_proc/sierra/ids/sierra_ids.lib/bn_mp_2expt.o,96,0,0,0,96,0,0
modem_proc/sierra/ids/sierra_ids.lib/bn_mp_add.o,84,0,0,0,84,0,0
modem_proc/sierra/ids/sierra_ids.lib/bn_mp_add_d.o,308,0,0,0,308,0,0
modem_proc/sierra/ids/sierra_ids.lib/bn_mp_clamp.o,64,0,0,0,64,0,0
modem_proc/sierra/ids/sierra_ids.lib/bn_mp_clear.o,80,0,0,0,80,0,0
modem_proc/sierra/ids/sierra_ids.lib/bn_mp_cmp.o,40,0,0,0,40,0,0
modem_proc/sierra/ids/sierra_ids.lib/bn_mp_cmp_d.o,52,0,0,0,52,0,0
modem_proc/sierra/ids/sierra_ids.lib/bn_mp_cmp_mag.o,88,0,0,0,88,0,0
modem_proc/sierra/ids/sierra_ids.lib/bn_mp_cnt_lsb.o,92,64,0,0,156,0,0
modem_proc/sierra/ids/sierra_ids.lib/bn_mp_copy.o,132,0,0,0,132,0,0
modem_proc/sierra/ids/sierra_ids.lib/bn_mp_count_bits.o,44,0,0,0,44,0,0
modem_proc/sierra/ids/sierra_ids.lib/bn_mp_div.o,1060,0,0,0,1060,0,0
modem_proc/sierra/ids/sierra_ids.lib/bn_mp_div_2.o,152,0,0,0,152,0,0
modem_proc/sierra/ids/sierra_ids.lib/bn_mp_div_2d.o,300,0,0,0,300,0,0
modem_proc/sierra/ids/sierra_ids.lib/bn_mp_exch.o,64,0,0,0,64,0,0
modem_proc/sierra/ids/sierra_ids.lib/bn_mp_exptmod.o,272,0,0,0,272,0,0
modem_proc/sierra/ids/sierra_ids.lib/bn_mp_exptmod_fast.o,1092,0,0,0,1092,0,0
modem_proc/sierra/ids/sierra_ids.lib/bn_mp_gcd.o,340,0,0,0,340,0,0
modem_proc/sierra/ids/sierra_ids.lib/bn_mp_get_int.o,92,0,0,0,92,0,0
modem_proc/sierra/ids/sierra_ids.lib/bn_mp_grow.o,140,0,0,0,140,0,0
modem_proc/sierra/ids/sierra_ids.lib/bn_mp_init.o,80,0,0,0,80,0,0
modem_proc/sierra/ids/sierra_ids.lib/bn_mp_init_copy.o,32,0,0,0,32,0,0
modem_proc/sierra/ids/sierra_ids.lib/bn_mp_init_size.o,112,0,0,0,112,0,0
modem_proc/sierra/ids/sierra_ids.lib/bn_mp_invmod.o,48,0,0,0,48,0,0
modem_proc/sierra/ids/sierra_ids.lib/bn_mp_invmod_slow.o,832,0,0,0,832,0,0
modem_proc/sierra/ids/sierra_ids.lib/bn_mp_lcm.o,160,0,0,0,160,0,0
modem_proc/sierra/ids/sierra_ids.lib/bn_mp_lshd.o,148,0,0,0,148,0,0
modem_proc/sierra/ids/sierra_ids.lib/bn_mp_mod.o,104,0,0,0,104,0,0
modem_proc/sierra/ids/sierra_ids.lib/bn_mp_mod_2d.o,184,0,0,0,184,0,0
modem_proc/sierra/ids/sierra_ids.lib/bn_mp_mod_d.o,8,0,0,0,8,0,0
modem_proc/sierra/ids/sierra_ids.lib/bn_mp_montgomery_calc_normalization.o,156,0,0,0,156,0,0
modem_proc/sierra/ids/sierra_ids.lib/bn_mp_montgomery_reduce.o,304,0,0,0,304,0,0
modem_proc/sierra/ids/sierra_ids.lib/bn_mp_montgomery_setup.o,88,0,0,0,88,0,0
modem_proc/sierra/ids/sierra_ids.lib/bn_mp_mul.o,128,0,0,0,128,0,0
modem_proc/sierra/ids/sierra_ids.lib/bn_mp_mul_2.o,172,0,0,0,172,0,0
modem_proc/sierra/ids/sierra_ids.lib/bn_mp_mul_2d.o,216,0,0,0,216,0,0
modem_proc/sierra/ids/sierra_ids.lib/bn_mp_mul_d.o,172,0,0,0,172,0,0
modem_proc/sierra/ids/sierra_ids.lib/bn_mp_mulmod.o,84,0,0,0,84,0,0
modem_proc/sierra/ids/sierra_ids.lib/bn_mp_neg.o,56,0,0,0,56,0,0
modem_proc/sierra/ids/sierra_ids.lib/bn_mp_prime_is_prime.o,208,0,0,0,208,0,0
modem_proc/sierra/ids/sierra_ids.lib/bn_mp_prime_miller_rabin.o,316,0,0,0,316,0,0
modem_proc/sierra/ids/sierra_ids.lib/bn_mp_read_radix.o,212,0,0,0,212,0,0
modem_proc/sierra/ids/sierra_ids.lib/bn_mp_read_unsigned_bin.o,112,0,0,0,112,0,0
modem_proc/sierra/ids/sierra_ids.lib/bn_mp_reduce_2k.o,188,0,0,0,188,0,0
modem_proc/sierra/ids/sierra_ids.lib/bn_mp_reduce_2k_setup.o,116,0,0,0,116,0,0
modem_proc/sierra/ids/sierra_ids.lib/bn_mp_reduce_is_2k.o,100,0,0,0,100,0,0
modem_proc/sierra/ids/sierra_ids.lib/bn_mp_reduce_is_2k_l.o,80,0,0,0,80,0,0
modem_proc/sierra/ids/sierra_ids.lib/bn_mp_rshd.o,96,0,0,0,96,0,0
modem_proc/sierra/ids/sierra_ids.lib/bn_mp_set.o,48,0,0,0,48,0,0
modem_proc/sierra/ids/sierra_ids.lib/bn_mp_set_int.o,80,0,0,0,80,0,0
modem_proc/sierra/ids/sierra_ids.lib/bn_mp_sqr.o,104,0,0,0,104,0,0
modem_proc/sierra/ids/sierra_ids.lib/bn_mp_sqrmod.o,76,0,0,0,76,0,0
modem_proc/sierra/ids/sierra_ids.lib/bn_mp_sub.o,92,0,0,0,92,0,0
modem_proc/sierra/ids/sierra_ids.lib/bn_mp_sub_d.o,252,0,0,0,252,0,0
modem_proc/sierra/ids/sierra_ids.lib/bn_mp_to_unsigned_bin.o,116,0,0,0,116,0,0
modem_proc/sierra/ids/sierra_ids.lib/bn_mp_toom_mul.o,1480,0,0,0,1480,0,0
modem_proc/sierra/ids/sierra_ids.lib/bn_mp_toom_sqr.o,1076,0,0,0,1076,0,0
modem_proc/sierra/ids/sierra_ids.lib/bn_mp_toradix.o,212,0,0,0,212,0,0
modem_proc/sierra/ids/sierra_ids.lib/bn_mp_unsigned_bin_size.o,44,0,0,0,44,0,0
modem_proc/sierra/ids/sierra_ids.lib/bn_mp_zero.o,40,0,0,0,40,0,0
modem_proc/sierra/ids/sierra_ids.lib/bn_reverse.o,56,0,0,0,56,0,0
modem_proc/sierra/ids/sierra_ids.lib/bn_s_mp_add.o,232,0,0,0,232,0,0
modem_proc/sierra/ids/sierra_ids.lib/bn_s_mp_exptmod.o,956,0,0,0,956,0,0
modem_proc/sierra/ids/sierra_ids.lib/bn_s_mp_mul_digs.o,220,0,0,0,220,0,0
modem_proc/sierra/ids/sierra_ids.lib/bn_s_mp_sqr.o,352,0,0,0,352,0,0
modem_proc/sierra/ids/sierra_ids.lib/bn_s_mp_sub.o,208,0,0,0,208,0,0
modem_proc/sierra/ids/sierra_ids.lib/omc_mmi_impl.o,724,532,0,348,1604,0,0
modem_proc/sierra/ids/sierra_ids.lib/omc_log_impl.o,1256,2878,0,0,4134,1,0
modem_proc/sierra/ids/sierra_ids.lib/omc_strchr.o,4,0,0,0,4,0,0
modem_proc/sierra/ids/sierra_ids.lib/omc_strrchr.o,4,0,0,0,4,0,0
modem_proc/sierra/ids/sierra_ids.lib/omc_strcmp.o,4,0,0,0,4,0,0
modem_proc/sierra/ids/sierra_ids.lib/omc_strncmp.o,4,0,0,0,4,0,0
modem_proc/sierra/ids/sierra_ids.lib/omc_strcpy.o,4,0,0,0,4,0,0
modem_proc/sierra/ids/sierra_ids.lib/omc_strncpy.o,4,0,0,0,4,0,0
modem_proc/sierra/ids/sierra_ids.lib/omc_strcat.o,4,0,0,0,4,0,0
modem_proc/sierra/ids/sierra_ids.lib/omc_atoiu32.o,308,0,0,0,308,0,0
modem_proc/sierra/ids/sierra_ids.lib/omc_debug.o,88,54,0,0,142,0,1
modem_proc/sierra/ids/sierra_ids.lib/omc_diag.o,84,61,0,0,145,1,0
modem_proc/sierra/ids/sierra_ids.lib/omc_memcpy.o,4,0,0,0,4,0,0
modem_proc/sierra/ids/sierra_ids.lib/omc_memcmp.o,4,0,0,0,4,0,0
modem_proc/sierra/ids/sierra_ids.lib/omc_timestr.o,440,0,8,0,448,0,0
modem_proc/sierra/ids/sierra_ids.lib/omc_assert.o,12,55,0,0,67,1,0
modem_proc/sierra/ids/sierra_ids.lib/omc_userdata.o,12,0,0,0,12,0,0
modem_proc/sierra/ids/sierra_ids.lib/devprop_devtyp.o,72,47,0,0,119,0,0
modem_proc/sierra/ids/sierra_ids.lib/devprop_hwv.o,68,38,0,0,106,0,0
modem_proc/sierra/ids/sierra_ids.lib/devprop_lang.o,72,47,0,0,119,0,0
modem_proc/sierra/ids/sierra_ids.lib/devprop_man.o,68,38,0,0,106,0,0
modem_proc/sierra/ids/sierra_ids.lib/devprop_mod.o,68,38,0,0,106,0,0
modem_proc/sierra/ids/sierra_ids.lib/devprop_oem.o,68,38,0,0,106,0,0
modem_proc/sierra/ids/sierra_ids.lib/devprop_swv.o,136,76,0,0,212,0,0
modem_proc/sierra/ids/sierra_ids.lib/devprop_devid.o,68,40,0,0,108,0,0
modem_proc/sierra/ids/sierra_ids.lib/tree_flags.o,108,102,0,0,210,0,0
modem_proc/sierra/ids/sierra_ids.lib/tree_read.o,408,235,0,0,643,0,0
modem_proc/sierra/ids/sierra_ids.lib/tree_readxml.o,3304,993,0,0,4297,0,0
modem_proc/sierra/ids/sierra_ids.lib/tree_writexml.o,1736,335,0,0,2071,0,0
modem_proc/sierra/ids/sierra_ids.lib/omc_dump.o,416,0,0,0,416,0,0
modem_proc/sierra/ids/sierra_ids.lib/omc_hex.o,184,0,0,0,184,0,0
modem_proc/sierra/ids/sierra_ids.lib/omc_postboot.o,4,0,0,0,4,0,0
modem_proc/sierra/ids/sierra_ids.lib/omc_progress.o,740,335,0,0,1075,0,0
modem_proc/sierra/ids/sierra_ids.lib/omc_string.o,68,97,0,0,165,0,0
modem_proc/sierra/ids/sierra_ids.lib/tman_add.o,3056,414,0,0,3470,0,0
modem_proc/sierra/ids/sierra_ids.lib/tman_delete.o,1488,231,0,0,1719,0,0
modem_proc/sierra/ids/sierra_ids.lib/tman_exec.o,156,161,0,0,317,0,0
modem_proc/sierra/ids/sierra_ids.lib/tman_find.o,140,138,0,0,278,0,0
modem_proc/sierra/ids/sierra_ids.lib/tman_moid.o,88,56,0,0,144,0,0
modem_proc/sierra/ids/sierra_ids.lib/trg_bootstrap.o,780,380,0,0,1160,0,0
modem_proc/sierra/ids/sierra_ids.lib/trg_debug.o,152,17,0,0,169,0,0
modem_proc/sierra/ids/sierra_ids.lib/trg_cmdline.o,472,414,0,0,886,1,1
modem_proc/sierra/ids/sierra_ids.lib/trg_time_id.o,28,0,0,0,28,0,0
modem_proc/sierra/ids/sierra_ids.lib/libmem.o,80,0,0,0,80,0,0
modem_proc/sierra/ids/sierra_ids.lib/libstr.o,76,0,0,0,76,0,0
modem_proc/sierra/ids/sierra_ids.lib/mgrcmdbuilder.o,836,237,0,0,1073,0,0
modem_proc/sierra/ids/sierra_ids.lib/mgrcmddispatcher.o,840,114,0,0,954,0,0
modem_proc/sierra/ids/sierra_ids.lib/mgrinstancelist.o,176,0,0,0,176,0,0
modem_proc/sierra/ids/sierra_ids.lib/mgrinstancemgr.o,1056,254,0,0,1310,0,0
modem_proc/sierra/ids/sierra_ids.lib/mgrutil.o,2196,776,0,0,2972,0,0
modem_proc/sierra/ids/sierra_ids.lib/xltdec.o,7788,432,0,0,8220,0,0
modem_proc/sierra/ids/sierra_ids.lib/xltdecwbxml.o,2724,0,0,0,2724,0,0
modem_proc/sierra/ids/sierra_ids.lib/xltdecxml.o,3820,268,0,0,4088,0,0
modem_proc/sierra/ids/sierra_ids.lib/xltenc.o,4756,428,0,0,5184,0,0
modem_proc/sierra/ids/sierra_ids.lib/xltenccom.o,72,0,0,0,72,0,0
modem_proc/sierra/ids/sierra_ids.lib/xltencwbxml.o,768,8,0,0,776,0,0
modem_proc/sierra/ids/sierra_ids.lib/xltencxml.o,732,0,8,0,740,0,0
modem_proc/sierra/ids/sierra_ids.lib/xltmetinf.o,1352,60,0,0,1412,0,0
modem_proc/sierra/ids/sierra_ids.lib/xlttags.o,912,1324,0,0,2236,0,0
modem_proc/sierra/ids/sierra_ids.lib/xltutilstack.o,428,0,0,0,428,0,0
modem_proc/sierra/ids/sierra_ids.lib/xpt-tcp.o,2104,377,0,0,2481,0,0
modem_proc/sierra/ids/sierra_ids.lib/xpt-http.o,7284,871,0,0,8155,0,0
modem_proc/sierra/ids/sierra_ids.lib/callbacks.o,2724,566,0,0,3290,0,0
modem_proc/sierra/ids/sierra_ids.lib/sess_auth.o,4032,1927,0,0,5959,0,0
modem_proc/sierra/ids/sierra_ids.lib/sess_commands.o,4840,641,0,0,5481,0,0
modem_proc/sierra/ids/sierra_ids.lib/sess_comms.o,1116,250,0,0,1366,0,0
modem_proc/sierra/ids/sierra_ids.lib/sess_cpboot.o,2980,1316,48,0,4344,0,0
modem_proc/sierra/ids/sierra_ids.lib/sess_processcmds.o,3228,421,0,0,3649,0,0
modem_proc/sierra/ids/sierra_ids.lib/sess_results.o,2052,401,0,0,2453,0,0
modem_proc/sierra/ids/sierra_ids.lib/sess_setup.o,2264,1102,0,0,3366,0,0
modem_proc/sierra/ids/sierra_ids.lib/sess_status.o,2936,484,0,0,3420,0,0
modem_proc/sierra/ids/sierra_ids.lib/sess_dm_comms.o,2384,533,0,0,2917,0,0
modem_proc/sierra/ids/sierra_ids.lib/sess_dm_setup.o,1112,233,0,0,1345,0,0
modem_proc/sierra/ids/sierra_ids.lib/wbxml_common.o,1656,491,0,0,2147,0,0
modem_proc/sierra/ids/sierra_ids.lib/wbxml_omacp.o,2508,4131,0,0,6639,0,0
modem_proc/sierra/ids/sierra_ids.lib/omadl.o,4680,2147,0,0,6827,0,0
modem_proc/sierra/ids/sierra_ids.lib/fumo_prompt.o,480,317,0,0,797,0,0
modem_proc/sierra/ids/sierra_ids.lib/multi.o,176,0,0,0,176,0,0
modem_proc/sierra/ids/sierra_ids.lib/rand_prime.o,216,0,0,0,216,0,0
modem_proc/sierra/ids/sierra_ids.lib/crypt_hash_is_valid.o,28,0,0,0,28,0,0
modem_proc/sierra/ids/sierra_ids.lib/crypt_prng_is_valid.o,28,0,0,0,28,0,0
modem_proc/sierra/ids/sierra_ids.lib/der_decode_sequence_ex.o,836,64,0,0,900,0,0
modem_proc/sierra/ids/sierra_ids.lib/der_decode_sequence_multi.o,284,0,0,0,284,0,0
modem_proc/sierra/ids/sierra_ids.lib/der_length_sequence.o,316,64,0,0,380,0,0
modem_proc/sierra/ids/sierra_ids.lib/der_decode_short_integer.o,104,0,0,0,104,0,0
modem_proc/sierra/ids/sierra_ids.lib/der_length_short_integer.o,72,0,0,0,72,0,0
modem_proc/sierra/ids/sierra_ids.lib/der_decode_utctime.o,744,0,0,0,744,0,0
modem_proc/sierra/ids/sierra_ids.lib/der_length_utctime.o,48,0,0,0,48,0,0
modem_proc/sierra/ids/sierra_ids.lib/der_decode_utf8_string.o,356,0,0,0,356,0,0
modem_proc/sierra/ids/sierra_ids.lib/der_length_utf8_string.o,200,0,0,0,200,0,0
modem_proc/sierra/ids/sierra_ids.lib/pkcs_1_pss_decode.o,688,0,0,0,688,0,0
modem_proc/sierra/ids/sierra_ids.lib/pkcs_1_v1_5_decode.o,232,0,0,0,232,0,0
modem_proc/sierra/ids/sierra_ids.lib/bn_fast_mp_invmod.o,560,0,0,0,560,0,0
modem_proc/sierra/ids/sierra_ids.lib/bn_fast_mp_montgomery_reduce.o,436,0,0,0,436,0,0
modem_proc/sierra/ids/sierra_ids.lib/bn_fast_s_mp_mul_digs.o,272,0,0,0,272,0,0
modem_proc/sierra/ids/sierra_ids.lib/bn_fast_s_mp_sqr.o,288,0,0,0,288,0,0
modem_proc/sierra/ids/sierra_ids.lib/bn_mp_abs.o,44,0,0,0,44,0,0
modem_proc/sierra/ids/sierra_ids.lib/bn_mp_clear_multi.o,44,0,0,0,44,0,0
modem_proc/sierra/ids/sierra_ids.lib/bn_mp_div_3.o,372,0,8,0,380,0,0
modem_proc/sierra/ids/sierra_ids.lib/bn_mp_div_d.o,328,0,0,0,328,0,0
modem_proc/sierra/ids/sierra_ids.lib/bn_mp_dr_is_modulus.o,60,0,0,0,60,0,0
modem_proc/sierra/ids/sierra_ids.lib/bn_mp_dr_reduce.o,208,0,0,0,208,0,0
modem_proc/sierra/ids/sierra_ids.lib/bn_mp_dr_setup.o,24,0,0,0,24,0,0
modem_proc/sierra/ids/sierra_ids.lib/bn_mp_init_multi.o,112,0,0,0,112,0,0
modem_proc/sierra/ids/sierra_ids.lib/bn_mp_karatsuba_mul.o,544,0,0,0,544,0,0
modem_proc/sierra/ids/sierra_ids.lib/bn_mp_karatsuba_sqr.o,460,0,0,0,460,0,0
modem_proc/sierra/ids/sierra_ids.lib/bn_mp_prime_is_divisible.o,76,0,0,0,76,0,0
modem_proc/sierra/ids/sierra_ids.lib/bn_mp_reduce.o,268,0,0,0,268,0,0
modem_proc/sierra/ids/sierra_ids.lib/bn_mp_reduce_2k_l.o,152,0,0,0,152,0,0
modem_proc/sierra/ids/sierra_ids.lib/bn_mp_reduce_2k_setup_l.o,88,0,0,0,88,0,0
modem_proc/sierra/ids/sierra_ids.lib/bn_mp_reduce_setup.o,44,0,0,0,44,0,0
modem_proc/sierra/ids/sierra_ids.lib/bn_s_mp_mul_high_digs.o,256,0,0,0,256,0,0
modem_proc/sierra/ids/sierra_ids.lib/omc_strcasecmp.o,4,0,0,0,4,0,0
modem_proc/sierra/ids/sierra_ids.lib/omc_memmove.o,4,0,0,0,4,0,0
modem_proc/sierra/ids/sierra_ids.lib/tree_if.o,856,178,0,4108,5142,0,0
modem_proc/sierra/ids/sierra_ids.lib/hmac_sha.o,400,0,0,0,400,0,0
modem_proc/sierra/ids/sierra_ids.lib/xpt-auth.o,1184,5,0,0,1189,0,0
modem_proc/sierra/ids/sierra_ids.lib/xpt-b64.o,744,66,0,0,810,0,0
modem_proc/sierra/ids/sierra_ids.lib/comms_xpt_if.o,2728,1538,8,348,4622,0,0
modem_proc/sierra/ids/sierra_ids.lib/sess_calcsize.o,1420,105,0,0,1525,0,0
modem_proc/sierra/ids/sierra_ids.lib/sess_large.o,3000,963,0,0,3963,0,0
modem_proc/sierra/ids/sierra_ids.lib/der_decode_bit_string.o,216,0,0,0,216,0,0
modem_proc/sierra/ids/sierra_ids.lib/der_length_bit_string.o,88,0,0,0,88,0,0
modem_proc/sierra/ids/sierra_ids.lib/der_decode_boolean.o,64,0,0,0,64,0,0
modem_proc/sierra/ids/sierra_ids.lib/der_length_boolean.o,24,0,0,0,24,0,0
modem_proc/sierra/ids/sierra_ids.lib/der_decode_choice.o,520,56,0,0,576,0,0
modem_proc/sierra/ids/sierra_ids.lib/der_decode_ia5_string.o,212,0,0,0,212,0,0
modem_proc/sierra/ids/sierra_ids.lib/der_length_ia5_string.o,204,816,0,0,1020,0,0
modem_proc/sierra/ids/sierra_ids.lib/der_decode_integer.o,296,0,0,0,296,0,0
modem_proc/sierra/ids/sierra_ids.lib/der_length_integer.o,216,0,0,0,216,0,0
modem_proc/sierra/ids/sierra_ids.lib/der_decode_object_identifier.o,260,0,0,0,260,0,0
modem_proc/sierra/ids/sierra_ids.lib/der_length_object_identifier.o,240,0,0,0,240,0,0
modem_proc/sierra/ids/sierra_ids.lib/der_decode_octet_string.o,224,0,0,0,224,0,0
modem_proc/sierra/ids/sierra_ids.lib/der_length_octet_string.o,76,0,0,0,76,0,0
modem_proc/sierra/ids/sierra_ids.lib/der_decode_printable_string.o,212,0,0,0,212,0,0
modem_proc/sierra/ids/sierra_ids.lib/der_length_printable_string.o,204,592,0,0,796,0,0
modem_proc/sierra/ids/sierra_ids.lib/pkcs_1_mgf1.o,360,0,0,0,360,0,0
modem_proc/sierra/ids/sierra_ids.lib/bn_fast_s_mp_mul_high_digs.o,284,0,0,0,284,0,0
modem_proc/sierra/ids/sierra_ids.lib/digcalc.o,708,11,0,0,719,0,0
modem_proc/sierra/ids/sierra_ids.lib/xptcomm.o,4560,2546,24,20,7150,0,0
modem_proc/sierra/ids/sierra_ids.lib/omc_strncasecmp.o,4,0,0,0,4,0,0
modem_proc/sierra/ids/sierra_ids.lib/httptrans.o,1976,1061,0,4,3041,0,0
modem_proc/sierra/ids/sierra_ids.lib/omc_constants.o,0,1176,0,0,1176,0,0
modem_proc/sierra/ids/sierra_ids.lib/fumo_constants.o,0,364,2176,0,2540,0,0
modem_proc/sierra/ids/sierra_ids.lib/bn_prime_tab.o,0,1024,0,0,1024,0,0
modem_proc/sierra/ids/sierra_ids.lib/omc_cmdtable.o,0,130,0,0,130,0,0
modem_proc/sierra/ids/sierra_ids.lib/ssp_config.o,0,4,4,0,8,0,0
modem_proc/sierra/ids/sierra_ids.lib/bn_mp_radix_smap.o,0,65,4,0,69,0,0
modem_proc/sierra/ids/sierra_ids.lib/omc_config.o,0,0,44,0,44,0,0
modem_proc/sierra/ids/sierra_ids.lib/crypt_hash_descriptor.o,0,0,0,3328,3328,0,0
modem_proc/sierra/ids/sierra_ids.lib/crypt_cipher_descriptor.o,0,0,0,3072,3072,0,0
modem_proc/sierra/ids/sierra_ids.lib/crypt_prng_descriptor.o,0,0,0,1280,1280,0,0
modem_proc/sierra/ids/sierra_ids.lib/crypt_ltc_mp_descriptor.o,0,0,0,196,196,0,0
modem_proc/sierra/ids/sierra_ids.lib/bncore.o,0,0,16,0,16,0,0
modem_proc/sierra/imsw/sierra_imsw.lib/imsw_fota.o,808,157,4,1,970,0,11
modem_proc/sierra/imsw/sierra_imsw.lib/imsw_fw.o,3616,872,4,63,4555,1,41
modem_proc/sierra/imsw/sierra_imsw.lib/imsw_smem.o,948,126,0,4,1078,1,8
modem_proc/sierra/imsw/sierra_imsw.lib/imsw_task.o,480,257,0,256,993,4,4
modem_proc/sierra/imsw/sierra_imsw.lib/imsw_user.o,3916,2004,0,0,5920,16,66
modem_proc/sierra/imsw/sierra_imsw.lib/imsw_utils.o,1988,811,0,8,2807,3,36
modem_proc/sierra/imsw/sierra_imsw.lib/imsw_config.o,1984,952,0,28,2964,3,35
modem_proc/sierra/imsw/sierra_imsw.lib/imsw_sim.o,4940,2941,0,4,7885,5,109
modem_proc/sierra/imsw/sierra_imsw.lib/imsw_qmi.o,528,0,0,0,528,0,0
modem_proc/sierra/jam/sierra_jam.lib/jamtask.o,1848,208,0,6221,8277,0,18
modem_proc/sierra/jam/sierra_jam.lib/jamdet.o,1832,336,8,11,2187,0,31
modem_proc/sierra/jam/sierra_jam.lib/jamuser.o,484,48,0,0,532,0,6
modem_proc/sierra/ld/sierra_ld.lib/ldtask.o,1692,642,0,532,2866,6,9
modem_proc/sierra/ld/sierra_ld.lib/lduser.o,248,99,0,0,347,1,3
modem_proc/sierra/ld/sierra_ld.lib/ldsm.o,288,64,112,24,488,0,8
modem_proc/sierra/ld/sierra_ld.lib/ldcm.o,212,263,0,4,479,4,0
modem_proc/sierra/mm/sierra_mm_modem.lib/mm.o,1060,252,8,16,1336,2,6
modem_proc/sierra/nv/sierra_nv.lib/nvarchive.o,4684,1519,16,17064,23283,1,114
modem_proc/sierra/nv/sierra_nv.lib/nvcust.o,1356,313,2160,0,3829,2,7
modem_proc/sierra/nv/sierra_nv.lib/nvimei.o,1336,200,0,8,1544,2,7
modem_proc/sierra/nv/sierra_nv.lib/nvimswitch.o,2764,1872,0,0,4636,6,50
modem_proc/sierra/nv/sierra_nv.lib/nvpersist.o,9052,5755,16,16,14839,17,208
modem_proc/sierra/nv/sierra_nv.lib/nvtask.o,3452,1615,0,481,5548,24,24
modem_proc/sierra/nv/sierra_nv.lib/nvuser.o,2576,2093,22,7,4698,3,20
modem_proc/sierra/nv/sierra_nv.lib/nvuser_modem.o,4688,2767,4,0,7459,23,74
modem_proc/sierra/nv/sierra_nv.lib/nv_remote_svc.o,796,408,0,80,1284,6,10
modem_proc/sierra/nv/sierra_nv.lib/nv_efs_items.o,192,7293,0,0,7485,2,0
modem_proc/sierra/nv/sierra_nv.lib/nvutils.o,4968,3279,16,8,8271,38,55
modem_proc/sierra/nv/sierra_nv.lib/nvsubcfg.o,1548,599,16,156,2319,0,41
modem_proc/sierra/nv/sierra_nv.lib/nvrfdefault.o,512,3578,0,12,4102,2,0
modem_proc/sierra/nv/sierra_nv.lib/nvbackup.o,2356,1755,0,0,4111,2,80
modem_proc/sierra/nv/sierra_nv.lib/nvrestore.o,9116,5028,0,0,14144,7,217
modem_proc/sierra/nv/sierra_nv.lib/nvautoprov.o,1040,415,0,0,1455,3,14
modem_proc/sierra/nv/sierra_nv.lib/nv_swi_items.o,0,16760,0,0,16760,0,0
modem_proc/sierra/nv/sierra_nv.lib/nvdata.o,0,3688,0,0,3688,0,0
modem_proc/sierra/nv/sierra_nv.lib/nvrfdefault_ar7584.o,0,280,0,0,280,0,0
modem_proc/sierra/nv/sierra_nv.lib/nvrfoverride_ar7584.o,0,576,0,0,576,0,0
modem_proc/sierra/nv/sierra_nv.lib/nvrfdefault_ar7582.o,0,232,0,0,232,0,0
modem_proc/sierra/nv/sierra_nv.lib/nvrfoverride_ar7582.o,0,616,0,0,616,0,0
modem_proc/sierra/nv/sierra_nv.lib/nvrfdefault_ar7586.o,0,304,0,0,304,0,0
modem_proc/sierra/nv/sierra_nv.lib/nvrfoverride_ar7586.o,0,5296,0,0,5296,0,0
modem_proc/sierra/nv/sierra_nv.lib/nvrfdefault_ar7588.o,0,232,0,0,232,0,0
modem_proc/sierra/nv/sierra_nv.lib/nvrfoverride_ar7588.o,0,576,0,0,576,0,0
modem_proc/sierra/nv/sierra_nv.lib/nvrfdefault_wp7601.o,0,264,0,0,264,0,0
modem_proc/sierra/nv/sierra_nv.lib/nvrfoverride_wp7601.o,0,4536,0,0,4536,0,0
modem_proc/sierra/nv/sierra_nv.lib/nvrfdefault_wp7603.o,0,264,0,0,264,0,0
modem_proc/sierra/nv/sierra_nv.lib/nvrfoverride_wp7603.o,0,17512,0,0,17512,0,0
modem_proc/sierra/nv/sierra_nv.lib/nvrfdefault_wp7605.o,0,216,0,0,216,0,0
modem_proc/sierra/nv/sierra_nv.lib/nvrfoverride_wp7605.o,0,28040,0,0,28040,0,0
modem_proc/sierra/nv/sierra_nv.lib/nvrfdefault_wp7607.o,0,264,0,0,264,0,0
modem_proc/sierra/nv/sierra_nv.lib/nvrfoverride_wp7607.o,0,23088,0,0,23088,0,0
modem_proc/sierra/nv/sierra_nv.lib/nvrfdefault_wp7608.o,0,264,0,0,264,0,0
modem_proc/sierra/nv/sierra_nv.lib/nvrfoverride_wp7608.o,0,11176,0,0,11176,0,0
modem_proc/sierra/nv/sierra_nv.lib/nvrfdefault_wp7609.o,0,264,0,0,264,0,0
modem_proc/sierra/nv/sierra_nv.lib/nvrfoverride_wp7609.o,0,25576,0,0,25576,0,0
modem_proc/sierra/nv/sierra_nv.lib/nvrfdefault_wp7610.o,0,216,0,0,216,0,0
modem_proc/sierra/nv/sierra_nv.lib/nvrfoverride_wp7610.o,0,54592,0,0,54592,0,0
modem_proc/sierra/nv/sierra_nv.lib/nvrfdefault_wp7611.o,0,216,0,0,216,0,0
modem_proc/sierra/nv/sierra_nv.lib/nvrfoverride_wp7611.o,0,51216,0,0,51216,0,0
modem_proc/sierra/nv/sierra_nv.lib/nvrfdefault_ar8582.o,0,232,0,0,232,0,0
modem_proc/sierra/nv/sierra_nv.lib/nvrfoverride_ar8582.o,0,1096,0,0,1096,0,0
modem_proc/sierra/nv/sierra_nv.lib/nvrfdefault_wp7700.o,0,264,0,0,264,0,0
modem_proc/sierra/nv/sierra_nv.lib/nvrfoverride_wp7700.o,0,17784,0,0,17784,0,0
modem_proc/sierra/nv/sierra_nv.lib/nvrfdefault_wp7702.o,0,264,0,0,264,0,0
modem_proc/sierra/nv/sierra_nv.lib/nvrfoverride_wp7702.o,0,17784,0,0,17784,0,0
modem_proc/sierra/nv/sierra_nv.lib/nvrfdefault_common.o,0,296,0,0,296,0,0
modem_proc/sierra/nv/sierra_nv.lib/nvrfdefault_lte_common_rx0.o,0,688,0,0,688,0,0
modem_proc/sierra/nv/sierra_nv.lib/nvrfdefault_lte_common_tx0.o,0,1080,0,0,1080,0,0
modem_proc/sierra/nv/sierra_nv.lib/nvrfdefault_gsm_g1800_rx0.o,0,88,0,0,88,0,0
modem_proc/sierra/nv/sierra_nv.lib/nvrfdefault_gsm_g1800_tx0.o,0,1096,0,0,1096,0,0
modem_proc/sierra/nv/sierra_nv.lib/nvrfdefault_gsm_g1900_rx0.o,0,88,0,0,88,0,0
modem_proc/sierra/nv/sierra_nv.lib/nvrfdefault_gsm_g1900_tx0.o,0,1096,0,0,1096,0,0
modem_proc/sierra/nv/sierra_nv.lib/nvrfdefault_gsm_g900_rx0.o,0,88,0,0,88,0,0
modem_proc/sierra/nv/sierra_nv.lib/nvrfdefault_gsm_g900_tx0.o,0,1096,0,0,1096,0,0
modem_proc/sierra/nv/sierra_nv.lib/nvrfdefault_gsm_g850_rx0.o,0,88,0,0,88,0,0
modem_proc/sierra/nv/sierra_nv.lib/nvrfdefault_gsm_g850_tx0.o,0,1096,0,0,1096,0,0
modem_proc/sierra/nv/sierra_nv.lib/nvrfdefault_lte_b1_rx0.o,0,176,0,0,176,0,0
modem_proc/sierra/nv/sierra_nv.lib/nvrfdefault_lte_b1_tx0.o,0,3112,0,0,3112,0,0
modem_proc/sierra/nv/sierra_nv.lib/nvrfdefault_lte_b20_rx0.o,0,96,0,0,96,0,0
modem_proc/sierra/nv/sierra_nv.lib/nvrfdefault_lte_b20_tx0.o,0,3104,0,0,3104,0,0
modem_proc/sierra/nv/sierra_nv.lib/nvrfdefault_lte_b18_rx0.o,0,96,0,0,96,0,0
modem_proc/sierra/nv/sierra_nv.lib/nvrfdefault_lte_b18_tx0.o,0,3104,0,0,3104,0,0
modem_proc/sierra/nv/sierra_nv.lib/nvrfdefault_lte_b19_rx0.o,0,96,0,0,96,0,0
modem_proc/sierra/nv/sierra_nv.lib/nvrfdefault_lte_b19_tx0.o,0,3104,0,0,3104,0,0
modem_proc/sierra/nv/sierra_nv.lib/nvrfdefault_lte_b28_rx0.o,0,96,0,0,96,0,0
modem_proc/sierra/nv/sierra_nv.lib/nvrfdefault_lte_b28_tx0.o,0,3144,0,0,3144,0,0
modem_proc/sierra/nv/sierra_nv.lib/nvrfdefault_lte_b3_rx0.o,0,176,0,0,176,0,0
modem_proc/sierra/nv/sierra_nv.lib/nvrfdefault_lte_b3_tx0.o,0,3104,0,0,3104,0,0
modem_proc/sierra/nv/sierra_nv.lib/nvrfdefault_lte_b4_rx0.o,0,176,0,0,176,0,0
modem_proc/sierra/nv/sierra_nv.lib/nvrfdefault_lte_b4_tx0.o,0,3128,0,0,3128,0,0
modem_proc/sierra/nv/sierra_nv.lib/nvrfdefault_lte_b8_rx0.o,0,96,0,0,96,0,0
modem_proc/sierra/nv/sierra_nv.lib/nvrfdefault_lte_b8_tx0.o,0,3104,0,0,3104,0,0
modem_proc/sierra/nv/sierra_nv.lib/nvrfdefault_lte_b2_rx0.o,0,176,0,0,176,0,0
modem_proc/sierra/nv/sierra_nv.lib/nvrfdefault_lte_b2_tx0.o,0,3128,0,0,3128,0,0
modem_proc/sierra/nv/sierra_nv.lib/nvrfdefault_lte_b5_rx0.o,0,96,0,0,96,0,0
modem_proc/sierra/nv/sierra_nv.lib/nvrfdefault_lte_b5_tx0.o,0,3104,0,0,3104,0,0
modem_proc/sierra/nv/sierra_nv.lib/nvrfdefault_lte_b13_rx0.o,0,96,0,0,96,0,0
modem_proc/sierra/nv/sierra_nv.lib/nvrfdefault_lte_b13_tx0.o,0,3144,0,0,3144,0,0
modem_proc/sierra/nv/sierra_nv.lib/nvrfdefault_lte_b14_rx0.o,0,96,0,0,96,0,0
modem_proc/sierra/nv/sierra_nv.lib/nvrfdefault_lte_b14_tx0.o,0,3144,0,0,3144,0,0
modem_proc/sierra/nv/sierra_nv.lib/nvrfdefault_lte_b12_rx0.o,0,96,0,0,96,0,0
modem_proc/sierra/nv/sierra_nv.lib/nvrfdefault_lte_b12_tx0.o,0,3104,0,0,3104,0,0
modem_proc/sierra/nv/sierra_nv.lib/nvrfdefault_lte_b17_rx0.o,0,96,0,0,96,0,0
modem_proc/sierra/nv/sierra_nv.lib/nvrfdefault_lte_b17_tx0.o,0,3112,0,0,3112,0,0
modem_proc/sierra/nv/sierra_nv.lib/nvrfdefault_lte_b26_rx0.o,0,96,0,0,96,0,0
modem_proc/sierra/nv/sierra_nv.lib/nvrfdefault_lte_b26_tx0.o,0,3104,0,0,3104,0,0
modem_proc/sierra/nv/sierra_nv.lib/nvrfdefault_lte_b34_rx0.o,0,96,0,0,96,0,0
modem_proc/sierra/nv/sierra_nv.lib/nvrfdefault_lte_b34_tx0.o,0,2824,0,0,2824,0,0
modem_proc/sierra/nv/sierra_nv.lib/nvrfdefault_lte_b39_rx0.o,0,176,0,0,176,0,0
modem_proc/sierra/nv/sierra_nv.lib/nvrfdefault_lte_b39_tx0.o,0,2864,0,0,2864,0,0
modem_proc/sierra/nvup/sierra_nvup.lib/nvup_core.o,7144,1528,16,68,8756,2,128
modem_proc/sierra/nvup/sierra_nvup.lib/nvup_modem.o,2116,473,0,0,2589,1,38
modem_proc/sierra/os/sierra_os.lib/ostime_modem.o,504,307,0,20,831,6,0
modem_proc/sierra/os/sierra_os.lib/osuser_modem.o,1880,867,16,1127196,1129959,18,3
modem_proc/sierra/os/sierra_os.lib/osdsm.o,524,418,0,0,942,5,2
modem_proc/sierra/os/sierra_os.lib/osnv.o,120,0,0,0,120,0,0
modem_proc/sierra/os/sierra_os.lib/osuser.o,408,351,0,0,759,7,0
modem_proc/sierra/pc/sierra_pc.lib/pcdisable.o,260,16,0,84,360,0,2
modem_proc/sierra/pc/sierra_pc.lib/pcpm.o,672,267,108,40,1087,2,5
modem_proc/sierra/pc/sierra_pc.lib/pctask.o,1980,1565,0,433,3978,10,17
modem_proc/sierra/pc/sierra_pc.lib/pctemp.o,1340,603,12,172,2127,8,11
modem_proc/sierra/pc/sierra_pc.lib/pcvolt.o,948,369,12,75,1404,5,7
modem_proc/sierra/pc/sierra_pc.lib/pccm.o,352,345,2,4,703,5,3
modem_proc/sierra/pc/sierra_pc.lib/pctables.o,212,5904,0,0,6116,0,5
modem_proc/sierra/pc/sierra_pc.lib/pcpatemp.o,792,383,12,84,1271,6,8
modem_proc/sierra/pc/sierra_pc.lib/pcpasm.o,164,224,16,16,420,3,0
modem_proc/sierra/pc/sierra_pc.lib/pcuser.o,464,951,0,4,1419,0,40
modem_proc/sierra/pc/sierra_pc.lib/pcsm.o,1088,949,248,76,2361,3,34
modem_proc/sierra/pc/sierra_pc.lib/pcsensm.o,244,209,56,0,509,3,0
modem_proc/sierra/pc/sierra_pc.lib/pc_qapi_modem.o,424,146,0,0,570,1,10
modem_proc/sierra/pi/sierra_pi.lib/pi.o,204,0,0,0,204,0,0
modem_proc/sierra/qapi/sierra_qapi.lib/qapi_client.o,3940,2222,48,848,7058,36,38
modem_proc/sierra/qapi/sierra_qapi.lib/qapi_server.o,1756,1062,16,728,3562,17,19
modem_proc/sierra/qapi/sierra_qapi.lib/qapi_ping_svc.o,144,102,0,0,246,0,5
modem_proc/sierra/qapi/sierra_qapi.lib/qapi_utils.o,64,97,0,0,161,2,0
modem_proc/sierra/qapi/sierra_qapi.lib/qapi_m2m_general_svc.o,7260,2878,1,344,10483,16,145
modem_proc/sierra/qapi/sierra_qapi.lib/qapi_m2m_realtime_svc.o,2320,864,0,344,3528,6,41
modem_proc/sierra/qapi/sierra_qapi.lib/qapi_sfs_svc.o,2644,1323,0,344,4311,14,53
modem_proc/sierra/ql/sierra_ql.lib/qluser.o,424,1027,0,0,1451,17,0
modem_proc/sierra/qmiidl/sierra_qmiidl.lib/qapi_apss_0_v01.o,32,240,56,0,328,0,0
modem_proc/sierra/qmiidl/sierra_qmiidl.lib/qapi_m2m_general_v01.o,32,3960,64,0,4056,0,0
modem_proc/sierra/qmiidl/sierra_qmiidl.lib/qapi_m2m_realtime_v01.o,32,496,64,0,592,0,0
modem_proc/sierra/qmiidl/sierra_qmiidl.lib/qapi_mpss_0_v01.o,32,240,60,0,332,0,0
modem_proc/sierra/qmiidl/sierra_qmiidl.lib/qapi_sfs_v01.o,32,560,64,0,656,0,0
modem_proc/sierra/qmiidl/sierra_qmiidl.lib/swiqmi_audio_v01.o,32,3704,64,0,3800,0,0
modem_proc/sierra/qmiidl/sierra_qmiidl.lib/bsp_service_type_messages_v01.o,32,228,60,0,320,0,0
modem_proc/sierra/qmiidl/sierra_qmiidl.lib/swiqmi_loc_v01.o,32,248,56,0,336,0,0
modem_proc/sierra/qmiidl/sierra_qmiidl.lib/swiqmi_omadm_v01.o,32,544,56,0,632,0,0
modem_proc/sierra/qmiidl/sierra_qmiidl.lib/swiqmi_sar_v01.o,32,240,56,0,328,0,0
modem_proc/sierra/qmiidl/sierra_qmiidl.lib/swiqmi_swidms_v01.o,32,436,56,0,524,0,0
modem_proc/sierra/qmiidl/sierra_qmiidl.lib/qapi_common_v01.o,0,888,4,0,892,0,0
modem_proc/sierra/qmiidl/sierra_qmiidl.lib/qapi_swi_common_v01.o,0,277,8,0,285,0,0
modem_proc/sierra/ay/sierra_ay_modem.lib/ayuser.o,380,41,0,0,421,0,3
modem_proc/sierra/bc/sierra_bc.lib/bcmsg.o,1472,334,0,24,1830,7,0
modem_proc/sierra/bc/sierra_bc.lib/bcmsg_modem.o,128,130,0,4,262,2,0
modem_proc/sierra/bc/sierra_bc.lib/bcuser.o,800,796,0,4,1600,2,2
modem_proc/sierra/bc/sierra_bc.lib/bccommon.o,304,48,0,0,352,0,6
modem_proc/sierra/bst/sierra_bst_modem.lib/redblack.o,764,53,0,0,817,1,0
modem_proc/sierra/cr/sierra_cr.lib/crcrc32.o,48,1024,0,0,1072,0,0
modem_proc/sierra/cwe/sierra_cwe_modem.lib/cweuser.o,2132,972,0,0,3104,11,20
modem_proc/sierra/cwe/sierra_cwe_modem.lib/cwe_target.o,852,279,0,0,1131,1,12
modem_proc/sierra/da/sierra_da.lib/dauser.o,10004,3391,14,8,13417,17,54
modem_proc/sierra/dbi/sierra_dbi.lib/dbi_qmi_mpss.o,192,528,0,8,728,3,20
modem_proc/sierra/ef/sierra_ef.lib/efuser.o,2180,162,4,12,2358,2,3
modem_proc/sierra/ef/sierra_ef.lib/eftest.o,1168,502,4,0,1674,6,1
modem_proc/sierra/ef/sierra_ef.lib/eflog.o,2000,71,0,72,2143,0,2
modem_proc/sierra/er/sierra_er.lib/eruser.o,3020,427,0,37,3484,3,4
modem_proc/sierra/er/sierra_er.lib/ercommon.o,1284,156,38,1024,2502,0,0
modem_proc/sierra/er/sierra_er.lib/erformat.o,4380,621,136,0,5137,1,0
modem_proc/sierra/er/sierra_er.lib/erutil.o,88,0,0,0,88,0,0
modem_proc/sierra/er/sierra_er.lib/er_reset_info.o,464,242,16,259,981,3,4
modem_proc/sierra/mci/sierra_mci.lib/mci_qapi_client.o,516,214,0,8,738,2,11
modem_proc/sierra/sec/sierra_sec.lib/sec_keys.o,32,0,0,0,32,0,0
modem_proc/sierra/tm/sierra_tm.lib/tm_mpps.o,1112,198,16,164,1490,2,9